//MAP CONVERTED BY dmm2tgm.py THIS HEADER COMMENT PREVENTS RECONVERSION, DO NOT REMOVE
"a" = (
/turf/open/floor/iron,
/area/station/service/bar)
"b" = (
/turf/open/space/basic,
/area/station/security)
"o" = (
/turf/open/floor/iron,
/area/station/science)
"r" = (
/turf/open/space/basic,
/area/station/science)
"z" = (
/turf/open/floor/iron,
/area/station/security)
"H" = (
/turf/open/floor/iron,
/area/station/command/bridge)
"M" = (
/turf/open/space/basic,
/area/station/command/bridge)
"N" = (
/turf/closed/wall,
/area/space)
"R" = (
/turf/open/space/basic,
/area/space)

(1,1,1) = {"
R
R
R
R
R
R
R
R
R
R
"}
(2,1,1) = {"
R
R
R
R
R
R
R
R
R
R
"}
(3,1,1) = {"
R
R
N
N
N
N
N
N
R
R
"}
(4,1,1) = {"
R
R
N
a
a
a
a
N
R
R
"}
(5,1,1) = {"
R
R
N
a
a
a
a
N
R
R
"}
(6,1,1) = {"
R
R
N
a
a
a
a
N
R
R
"}
(7,1,1) = {"
R
R
N
a
a
a
a
N
R
R
"}
(8,1,1) = {"
R
R
N
N
N
N
N
N
R
R
"}
(9,1,1) = {"
R
R
R
R
R
R
R
R
R
R
"}
(10,1,1) = {"
R
R
R
R
R
R
R
R
R
R
"}

(1,1,2) = {"
R
R
R
R
R
R
R
R
R
R
"}
(2,1,2) = {"
R
R
R
R
R
R
R
R
R
R
"}
(3,1,2) = {"
R
R
N
N
N
N
N
N
R
R
"}
(4,1,2) = {"
R
R
N
z
z
z
z
N
R
R
"}
(5,1,2) = {"
R
R
N
z
z
z
z
N
R
R
"}
(6,1,2) = {"
R
R
N
z
z
b
z
N
R
R
"}
(7,1,2) = {"
R
R
N
z
z
z
z
N
R
R
"}
(8,1,2) = {"
R
R
N
N
N
N
N
N
R
R
"}
(9,1,2) = {"
R
R
R
R
R
R
R
R
R
R
"}
(10,1,2) = {"
R
R
R
R
R
R
R
R
R
R
"}

(1,1,3) = {"
R
R
R
R
R
R
R
R
R
R
"}
(2,1,3) = {"
R
R
R
R
R
R
R
R
R
R
"}
(3,1,3) = {"
R
R
N
N
N
N
N
N
R
R
"}
(4,1,3) = {"
R
R
N
H
H
H
H
N
R
R
"}
(5,1,3) = {"
R
R
N
H
H
H
H
N
R
R
"}
(6,1,3) = {"
R
R
N
H
M
H
H
N
R
R
"}
(7,1,3) = {"
R
R
N
H
H
H
H
N
R
R
"}
(8,1,3) = {"
R
R
N
N
N
N
N
N
R
R
"}
(9,1,3) = {"
R
R
R
R
R
R
R
R
R
R
"}
(10,1,3) = {"
R
R
R
R
R
R
R
R
R
R
"}
